Action=Acción
AddRvokeSysAdmin=Asignar / Revocar SysAdmin
ADMConfig=Configuración D365FO Admin Toolkit
ADMExportRoleAccess=Exportar Acceso a roles D365FO Admin Toolkit
ADMMaintain=Mantener D365FO Admin Toolkit
ADMSysAdmAssignment=Asignación SysAdmin D365FO Admin Toolkit
ADMView=Ver D365FO Admin Toolkit
ADMViewReport=Ver informe SysAdmin D365FO Admin Toolkit
Assigned=Asignado
AssignmentReason=Razón de la asignación
AssingSysAdmin=Asignar SysAdmin
ASTSysAdminChange=Admin Security Toolkit - Cambio SysAdmin
Cancel=Cancelar
ChangeReason=Razón de cambio asignación SysAdmin:
ConfigurationSetup=Configuración del sistema
DateTime=Fecha y hora
DefaultNumDaysReport=Número predeterminado de días para informes
EndDate=Fecha de fin:
ExportRoleAccess=Exportar acceso a roles
LastLogin=Último Acceso
ModifiedBy=Modificado por
NewLabel0=Label files created on 01/26/2024 18:04:13 for label file Id D365FOAdminToolkit and language en-US
 ;Label file comment - see above label
Reason=Razón
Revoked=Revocado
RevokeSysAdmin=Revocar SysAdmin
RoleAccessFileGenerated=Archivo de acceso a roles generado exitosamente.
ShowReasonDialog=Mostrar Cuadro de diálogo razón para SysAdmin
StartDate=Fecha de inicio:
Submit=Enviar
SysAdminAssignReport=Informe de asignación SysAdmin
SysAdminReport=Informe SysAdmin
User=Usuario
