Action=Actie
AddRemoveSelectedUsers=Geselecteerde gebruikers toevoegen/verwijderen
AddRevokeSysAdmin=Toewijzen / Intrekken SysAdmin
ADMConfig=D365FO Admin Toolkit Configuratie
ADMDisableUsersJob=D365FO Admin Toolkit Voer de taak Gebruikers uitschakelen uit
ADMExportRoleAccess=D365FO Admin Toolkit Rol toegang exporteren
ADMMaintain=D365FO Admin Toolkit Onderhouden
ADMSysAdmAssignment=D365FO Admin Toolkit SysAdmin Toewijzing
ADMView=D365FO Admin Toolkit Weergeven
ADMViewDisabledUsersReport=D365FO Admin Toolkit Bekijk het rapport over uitgeschakelde gebruikers
ADMViewReport=D365FO Admin Toolkit SysAdmin rapport weergeven
Assigned=Toegewezen
AssignmentReason=Toewijzing reden
AssingSysAdmin=SysAdmin Toewijzen
ASTSysAdminChange=Admin Security Toolkit - SysAdmin Wijziging
Cancel=Annuleren
ChangeReason=SysAdmin Assignment Wijziging reden :
ConfigurationSetup=Configuratie instellen
D365FOAdminToolkit=D365FO Admin Toolkit
 ;{locked}
DateTime=Datum Tijd
DefaultNumDaysReport=Standaard aantal dagen voor rapporten
DisableSysAdminBatchJobHelp=Deactiveert verlopen SysAdmin-roltoewijzingen
DisableSysAdminBatchJobLabel=Deactiveer verlopen SysAdmin-roltoewijzingen
DisableUserJob=Taak Gebruikers uitschakelen
DisableUserNumDays=Schakel Gebruikersaantal dagen uit
EmptyReason=Waarde voor Reden moet worden opgegeven.
EndDate=Eind datum :
EnvConfigFileGenerated=Omgeving Configuratie Bestand succesvol gegenereerd.
Environment=Omgeving
ExcludedUserList=Uitgesloten gebruikerslijst
ExcludedUsers=Uitgesloten gebruikers
ExportRoleAccess=Rol toegang exporteren
ExportSysConfig=Systeem Configuratie exporteren
General=Algemeen
InquiriesReports=Queries en Rapporten
LastLogin=Laatste inlog
ModifiedBy=Gewijzigd door
NumDaysLastLogin=Aantal dagen sinds laatste aanmelding:
Parameters=D365FO Admin Toolkit Parameters
PeriodicTasks=Periodieke taken
PopulateExcludedUserList=Lijst met uitgesloten gebruikers gevuld met serviceaccounts.
PopulateExcludedUsers=Vul uitgesloten gebruikers in
Reason=Reden
Revoked=Ingetrokken
RevokeSysAdmin=SysAdmin intrekken
RoleAccessFileGenerated=Rol toegang bestand succesvol gegenereerd
SendTelemetrySysAdminLogHelp=Stuurt telemetrie naar application insights wanneer een logboek wordt gemaakt in SysAdminLog
SendTelemetrySysAdminLogLabel=SysAdminLog
Setup=Instellen
ShowReasonDialog=Reden Dialoog voor SysAdmin tonen
ShowSysAdminExpiryDateDialog=Toon vervaldatum voor SysAdmin
StartDate=Begin Datum :
Submit=Indienen
SysAdmin=Systeembeheerder
SysAdminAssigned=SYSADMIN rol toegewezen aan %1
SysAdminAssignReport=SysAdmin Toewijzing Rapport
SysAdminExpiryDateDefaultHours=Standaard aantal uren
SysAdminNotAssigned=SYSADMIN rol niet toegewezen aan %1
SysAdminReport=SysAdmin Rapport
SysAdminRevoked=Rol SYSADMIN verwijderd van %1
User=Gebruiker
UserDisableMessage=Gebruikers zijn uitgeschakeld als ze %1 dagen niet hebben ingelogd.
UserDisableReport=Uitgeschakelde gebruikersrapport
UserDisableTitle=Schakel Gebruikersproces voltooid uit
UserId=Gebruikersidentificatie
UserList=Gebruikers Lijst
UserName=Gebruikersnaam
