Action=Handling
AddRemoveSelectedUsers=Tilføj / Fjern Valgte Brugere
AddRevokeSysAdmin=Tildel / Tilbagekald SysAdmin
ADMConfig=D365FO Admin Toolkit Konfiguration
ADMDisableUsersJob=D365FO Admin Toolkit Kør Deaktiver Brugere Kørsel
ADMExportRoleAccess=D365FO Admin Toolkit Eksporter Rolletildeling
ADMMaintain=D365FO Admin Toolkit Vedligehold
ADMSysAdmAssignment=D365FO Admin Toolkit SysAdmin Tildeling
ADMView=D365FO Admin Toolkit Vis
ADMViewDisabledUsersReport=D365FO Admin Toolkit Vis Deaktiverede Brugere Rapport
ADMViewReport=D365FO Admin Toolkit Vis SysAdmin Rapport
Assigned=Tildelt
AssignmentReason=Tildelingsårsag
AssingSysAdmin=Tildel SysAdmin
ASTSysAdminChange=Admin Security Toolkit - SysAdmin Ændringer
Cancel=Annuller
ChangeReason=SysAdmin Ændringsårsag :
ConfigurationSetup=Konfigurationsopsætning
D365FOAdminToolkit=D365FO Admin Toolkit
DateTime=Dato Tid
DefaultNumDaysReport=Standard Antal Dage for Rapporter
DisableSysAdminBatchJobHelp=Deaktiverer udløbne SysAdmin-rolletildelinger
DisableSysAdminBatchJobLabel=Deaktiver udløbne SysAdmin-rolletildelinger
DisableUserJob=Deaktivering af brugere
DisableUserNumDays=Deaktivering Bruger Dage
EmptyReason=Værdien Årsag Skal Være Udfyldt
EndDate=Slut dato :
EnvConfigFileGenerated=Miljøkonfigurationsfil Genereret.
Environment=Miljø
ExcludedUserList=Undtagede Brugere
ExcludedUsers=Undtagede Brugere
ExportRoleAccess=Eksporter Rolleadgange
ExportSysConfig=Eksporter Systemkonfiguration
General=Generel
InquiriesReports=Forespørgelser og Rapporter
LastLogin=Sidste Login
ModifiedBy=Ændret Af
NumDaysLastLogin=Antal Date Siden Sidste Login :
Parameters=D365FO Admin Toolkit Parametre
PeriodicTasks=Periodiske Handlinger
PopulateExcludedUserList=Generere Liste Af Undtagede Brugere med Servicekonti.
PopulateExcludedUsers=Generer Liste Af Undtagede Brugere
Reason=Årsag
Revoked=Tilbagekaldt
RevokeSysAdmin=Tilbagekald SysAdmin
RoleAccessFileGenerated=Rolleadgangsfil genereret.
Setup=Opsætning
ShowReasonDialog=Vis Årsagsdialog For SysAdmin
ShowSysAdminExpiryDateDialog=Vis udløbsdato for SysAdmin
StartDate=Start Dato :
Submit=Send
SysAdmin=Systemadministrator
SysAdminAssigned=Rollen SYSADMIN blev tildelt %1
SysAdminAssignReport=SysAdmin Tildelingsrapport
SysAdminExpiryDateDefaultHours=Standard antal timer
SysAdminNotAssigned=Rollen SYSADMIN er ikke tildelt %1
SysAdminReport=SysAdmin Rapport
SysAdminRevoked=Rollen SYSADMIN blev fjernet fra %1
User=Bruger
UserDisableMessage=Deaktiverede brugere der ikke har været logget ind i % dage.
UserDisableReport=Deaktiverede Brugere
UserDisableTitle=Brugere Deaktiveret
UserId=Bruger-id
UserList=Brugerliste
UserName=Brugernavn
