Action=Handling
AddRevokeSysAdmin=Tilordne / Oppheve SysAdmin
ADMConfig=D365FO Admin Toolkit Konfigurasjon
ADMExportRoleAccess=Eksporter rolletilgang til D365FO Admin Toolkit
ADMMaintain=Vedlikehold D365FO Admin Toolkit
ADMSysAdmAssignment=Tilordning D365FO Admin Toolkit SysAdmin
ADMView=Vis D365FO Admin Toolkit 
ADMViewReport=Vis SysAdmin rapport D365FO Admin Toolkit
Assigned=Tilordnet
AssignmentReason=Tilordningsårsak
AssingSysAdmin=Tilordne SysAdmin
ASTSysAdminChange=Admin Security Toolkit - Endre SysAdmin
Cancel=Avbryt
ChangeReason=SysAdmin Tilordning Endringsårsak :
ConfigurationSetup=Konfigurasjonsoppsett
D365FOAdminToolkit=D365FO Admin Verktøysett
DateTime=Dato Tid
DefaultNumDaysReport=Standard Antall Dager for Rapporter
EmptyReason=Verdi for grunn må oppgis.
EndDate=Sluttdato :
EnvConfigFileGenerated=Miljøkonfigurasjonsfil generert vellykket.
Environment=Miljø
ExportRoleAccess=Eksporter Rolletilgang
ExportSysConfig=Eksporter Systemkonfigurasjon
InquiriesReports=Forespørsler og Rapporter
LastLogin=Siste Innlogging
ModifiedBy=Endret av
Reason=Årsak
Revoked=Opphevet
RevokeSysAdmin=Opphev SysAdmin
RoleAccessFileGenerated=Rolletilgangsfil Generert Vellykket.
Setup=Oppsett
ShowReasonDialog=Vis årsaksdialog for SysAdmin
StartDate=Startdato :
Submit=Sende inn
SysAdmin=Systemadministrator
SysAdminAssigned=Tildelt SYSADMIN-rolle til %1
SysAdminAssignReport=SysAdmin Tilordningsrapport
SysAdminNotAssigned=SYSADMIN-rollen er ikke tildelt %1
SysAdminReport=SysAdmin Rapport
SysAdminRevoked=Fjernet SYSADMIN-rollen fra %1
User=Bruker
